------------------------------------------------------------------------------------------------------------------------------------------------------------------------------------------------------------------
------------------------------------------------------------------------------------------------------------------------------------------------------------------------------------------------------------------
------------------------------------------------------------------------------------------------------------------------------------------------------------------------------------------------------------------
-------------------------------------------------------------------------------G-G--------------------------------------------------------------------------------------------------------------------------------
---------------------?---------------------------------------------------------########---###?--------------m-----------###----#??#--------------------------------------------------------==---------------------
------------------------------------------------------------------------------------------------------------------------------------------------------------------------------------------===---------------------
-----------------------------------------------------------------------------------------------------------------------------------------------------------------------------------------====--------------F------
---------------------------------------------------------------E------------------------------------------------------------------------------------------------------------------------=====-------------CCC-----
---------------?---#m#?#---------------------NM---------LR------------------#m#--------------#-----#E----?--?--?-----#----------##------=--=----------==--=------------##?#------------======-------------C##-----
-------------------------------------LR------lr---------lr-----------------------------------------------------------------------------==--==--------===--==--------------------------=======------------CCCCC----
---------------------------LR--------lr------lr---------lr----------------------------------------------------------------------------===--===------====--===-----LR--------------LR-========------------##-##----
---------------------G-----lr--------lrG-----lr---GG----lr-------------------------------------G-G---------------G-G--------GG--GG---====--====----=====--====----lr----------GG--lr=========--------=---##-##----
====================================================================--===============---================================================================--========================================================